111111111111111111111111111
10C1100000000C0C00000000001
10011000000011111V000000001
10011000V111111111000000001
1P00000011111111111000C00E1
111111111111111111111111111

