111111111111111111111111111
10C1100V00000C0C000000000V1
10011C00000C11111V0000000E1
1C0011110000000001111111111
1000000000000000000000000C1
1000000000000V0000001111111
10011000V111111111000000001
1P000ooo11111111111V000C001
111111111111111111111111111
