111111111111111111111111111
10C1100V00000CVC000000000E1
10011000000011111V000000001
1V00000000000000000000000V1
100000000000000011111111111
100111111100000000000000001
1000000001000001000000C00V1
1000000001V0C0V100001111111
10011000V111111111000000001
1P000ooo11111111111V00C00C1
111111111111111111111111111

