1111111111111111
10C1100000000E11
1001100000001111
1001100000111111
1P00000011111111
1111111111111111
